
plus       - Plus                               +    
uplus      - Unary plus                         +    
minus      - Minus                              -    
uminus     - Unary minus                        -    
mtimes     - Matrix multiply                    *    
times      - Array multiply                    .*    
mpower     - Matrix power                       ^    
power      - Array power                       .^    
mldivide   - Backslash or left matrix divide    \    
mrdivide   - Slash or right matrix divide       /    
ldivide    - Left array divide                 .\    
rdivide    - Right array divide                ./    
kron       - Kronecker tensor product         kron   
eq         - Equal                             ==     
ne         - Not equal                         ~=     
lt         - Less than                          <      
gt         - Greater than                       >      
le         - Less than or equal                <=     
ge         - Greater than or equal             >=     
and        - Element-wise logical AND           &      
or         - Element-wise logical OR            |      
not        - Logical NOT                        ~      
xor        - Logical EXCLUSIVE OR
any        - True if any element of vector is nonzero
all        - True if all elements of vector are nonzero      
transpose  - Transpose                         .'
ctranspose - Complex conjugate transpose        ' 
horzcat    - Horizontal concatenation          [,]     
vertcat    - Vertical concatenation            [;]     
subsasgn   - Subscripted assignment          ( ),{ },.   
subsref    - Subscripted reference           ( ),{ },.   
subsindex  - Subscript index
# metaclass  - Metaclass for MATLAB class         ?
bitand     - Bit-wise AND.
bitcmp     - Complement bits.
bitor      - Bit-wise OR.
bitmax     - Maximum floating point integer.
bitxor     - Bit-wise XOR.
bitset     - Set bit.
bitget     - Get bit.
bitshift   - Bit-wise shift.
union      - Set union.
unique     - Set unique.
intersect  - Set intersection.
setdiff    - Set difference.
setxor     - Set exclusive-or.
ismember   - True for set member.
